NO ./xpm/540.xpm
SO ./xpm/green.xpm
WE ./xpm/test-_1_.xpm
EA ./xpm/test-_1_.xpm

F 100,100,100
C 0,255,255

       1111111111111111111111111
       1000000000110000000000001
       1011000001110000000000001
       1001000000000000000000001
111111111011000001110000000000001
100000000011000001110111111111111
11110111111111011100000010001
11110111111111011101010000001
11000000110101011100000010001
10000000000000000000000010001
10000000000000001101010010001
11000001110101011111011110N0111
11110111 1110101 100011010001
11111111 1111111 111111111111